##########-------##-###-#-##-----#-##-###-#-##-------##-#-###-##-#-----##-#-###-##-------##########
##########-------##-#-#-#-##---#-#-####-#-#-##---#---##-#-#-####-#-#---##-#-#-#-##-------##########
##########-------##-#####-##-------##-#-#-#-##---#---##-#-#-#-##-------##-#####-##-------##########
##########-------##-#-###-##-#---#-##-#-#---##-#-#-#-##---#-#-##-#---#-##-###-#-##-------##########
##########-------##-#-###-##-#-###-##-------##-##-##-##-------##-###-#-##-###-#-##-------##########
##########-------##-##-##-##-------##-#-#-#-##-#-#-#-##-#-#-#-##-------##-##-##-##-------##########
##########-------##-#####-##-------###-#-#-####-----####-#-#-###-------##-#####-##-------##########